  XXXXXXXXXXXXXXXXXXXXXXXXXXXXXXXXXXXXX
                          X   X     X X
XXXXX XXX X X XXXXX X X XXXXX X X X X X
X     X   X X X X   X X       X X X X X
XXX XXX X XXX X XXX XXX X X X X XXX X X
X   X X X   X X X X X   X X X   X   X X
X X X X X X XXX X X XXXXXXX X XXXXXXX X
X X   X X X X X     X   X X X     X   X
X X X XXXXX X XXXXXXX X X XXX XXXXXXX X
X X X     X   X X   X X X             X
XXXXX XXXXXXX X X XXXXX XXX XXX XXX X X
X     X                   X   X   X X X
XXX XXXXX X XXX XXXXX XXX XXXXXXX XXX X
X   X     X X       X X   X       X   
XXXXXXXXXXXXXXXXXXXXXXXXXXXXXXXXXXXXX 