  XXXXXXXXXXXXXXXXXXXXXXXXXXXXXXXXXXXXXXX
    X   X X     X     X   X X           X
X XXX XXX X XXXXXXXXX XXX X XXX XXX XXX X
X   X   X       X   X     X X     X X   X
X XXXXX X XXX XXX X X XXX X X X X X XXXXX
X     X     X   X X   X X     X X X   X X
X XXXXX XXX XXXXX X XXX X XXX XXXXX X X X
X     X X   X X   X X   X   X X   X X X X
XXX XXX XXX X XXXXX X X XXXXXXXXX X XXX X
X X X     X X X       X     X X   X     X
X X X XXXXXXX X XXXXXXXXXXX X X XXX XXX X
X     X   X X     X X X X X   X     X   X
XXX XXXXX X X X X X X X X X X X XXXXX X X
X X X X       X X X X   X   X X     X X X
X X X X XXX XXXXX X X X X XXX XXX XXXXX X
X         X   X       X X X     X   X   
XXXXXXXXXXXXXXXXXXXXXXXXXXXXXXXXXXXXXXX 
