  XXXXXXXXXXXXXXXXXXXXXXXXXXXXXXXXXXXXX
  X     X     X         X X   X     X X
X XXX XXXXX X XXXXXXX XXX X XXXXX X X X
X X         X X X X X   X     X   X   X
X XXXXXXX XXX X X X XXX X XXX X X XXXXX
X     X     X X   X   X     X   X X   X
X X XXX X XXX X XXX X XXXXXXXXX XXXXX X
X X   X X X   X   X X           X X X X
X XXXXX XXXXX X X X X XXX XXX X X X X X
X   X   X       X   X X     X X X X   X
X XXXXXXXXX XXXXXXX XXXXX XXX XXX X X X
X   X       X X   X X X   X   X     X X
X XXX X XXXXX XXX X X XXX XXX XXX X X X
X     X           X     X   X     X X 
XXXXXXXXXXXXXXXXXXXXXXXXXXXXXXXXXXXXX 