########################################
#E#                                 #   #
# # # # # # # # # # # # # # # # # # # # #
#               #                   #   #
# # # # # # #   # # # # # # # # # #   # #
#           #               #           #
# # # # # # # # # # # # #   # # # # # # #
#       #       #           #           #
# # #   # # #   # # # # # # #   # # #   #
#               #           #           #
# # # # # # # # # # # #   # # # # # #   #
#           #           #               #
# # # # # #   # # # # # # # # # # # # # #
#       #           #           #       #
# # #   # # #   #   # # # # # #   # # # #
#               #           #           #
# # # # # # # # # # # # # # # # # # # S #
########################################