XXXXXXXXXXXXXXXXXXXXXXXXXXXXXXXXXXXXXXXX
  X   X         X            XX   XX   X
X     X         X   XX  X X     X      X
X XXXXXXXXX XXX X XXXXX X XXX XXX XXXX X
X             X X   X X   X         X  X
X X XXX X XXXXXXXXX X X XXX X X XXX XXXX
X X   X X   XX    X   X   X X X X      X
XXXXX XXXXX XX  X   XXX XXXXXXX X XXX XX
X     X X       X         X     X   X  X
XXXXXXX X XXXXXXX XXX XXXXX XXXXXXX XX X
X         X   X X X X       X       X  X
X XXX XXXXX XXX X X XXXXX   X   X XXX XX
X X X         X X   X X     X   X X   XX
X X X X X XXXXX X X X X XXXXXXX X XX  XX
X X   X X     X   X   X         X       
XXXXXXXXXXXXXXXXXXXXXXXXXXXXXXXXXXXXXXXX