########################################
#E                       #              #
#   # # # # # # # # #   # # # # # # # # #
#       #   #           #               #
# # #   #   #   # # # # # # # # # # # # #
#       #   #               #           #
#####   #   # # #   # # # # #   # # #   #
#               #   #       #       #   #
# # # # # # #   # # #   # # #   # # #   #
#       #               #           #   #
#####   # # #   #   # # # # #   #   #   #
#       #       #   #       #       #   #
#####   # # #   #   #   # # #   #   #   #
#       #           #   #       #       #
# # # # #   # # # #   #   # # #   #   # #
#           #       #   #           #   #
#   # # #   #   #   #   # # # # #   #   #
#       #           #           #       #
# # # # #   #####   #   #########   #   #
#           #       #   #           #   #
#########   #   #   #   #########   #   #
#       #           #                   #
#########################################